10 17
--------////////-
--------/-----0/-
--------/-1/1-//-
--------/-1--1/--
--------//1-1-/--
/////////-1-/-///
/2222--//-1--1--/
//222----1--1---/
/2222--//////////
////////---------
