9 8
////////
///---//
/2-01-//
///-12//
/2//1-//
/-/-2-//
/1--112/
/----2-/
////////