13 22
--------------////////
--------------/--2222/
---////////////--2222/
---/----/--1-1---2222/
---/-111/1--1-/--2222/
---/--1-----1-/--2222/
---/-11-/1-1-1////////
////--1-/-----/-------
/---/-/////////-------
/----1--//------------
/-11/11-0/------------
/---/---//------------
/////////-------------