9 8
////////
///---//
/201--//
///-12//
/2//1-//
/-/-2-//
/1-3112/
/----2-/
////////