11 22
----/////-------------
----/---/-------------
----/1--/-------------
--///--1///-----------
--/--1--1-/-----------
///-/-///-/-----//////
/---/-///-///////--22/
/-1--1-------------22/
/////-////-/0////--22/
----/------///--//////
----////////----------